TTR = "countries/Techno Republic.txt"

HHE = "countries/Harmonain Empire.txt"
NWA = "countries/North Weastern Approach.txt"
BTF	= "countries/Blested Tiers Federation.txt"
LPA = "countries/Lower Peninsula.txt"
GSP = "countries/Grand Sea Protectorate.txt"
NRF = "countries/North River Federation.txt"
HPA	= "countries/Harmony Peninsula.txt"
AWA = "countries/Archaiga Western Approach.txt"
HCZ = "countries/Harmony Central Zone.txt"
HFB = "countries/Central Harmony Food Belt.txt"
HHC = "countries/Holy Harmonain Colony.txt"

TCI = "countries/Coneezean Imperium.txt"
TCM = "countries/Consortium"

SES = "countries/Sesencian Union.txt"
MUR = "countries/Sesencian Colony.txt"

ATL = "countries/Atlas.txt"

TKZ	= "countries/Kingdom of Zakariah.txt"
NZK	= "countries/Nezuko.txt"	# Dont let Kocomi make countries
DEK = "countries/Deku.txt"

ZUK	= "countries/Zukiinian Empire.txt"

USA = "countries/US of Archaiga.txt"

LLA	= "countries/Lataria.txt"

TST = "countries/The State.txt"
KEI = "countries/Kuewi.txt"
XIA = "countries/Xigadia.txt"
OIA = "countries/Onghinia.txt"
NTA = "countries/Netreta.txt"
IVR = "countries/Ilver.txt"
VNA = "countries/Vina.txt"

FFN	= "countries/Federation of Notogea.txt"
NUI = "countries/Notogea Unionist Islands.txt"

STE = "countries/Steel Empire.txt"	# Talk with Graf Zeppelin
UNP = "countries/Union of Notogaian People.txt"

TGC = "countries/Golden Coast.txt"
GPF = "countries/Golden People's Federation.txt"

KOE = "countries/Kingdom of the East.txt"
NCU = "countries/Northern Union.txt"

PDA	= "countries/Padeniye Anothority.txt"

MTA = "countries/Mostva.txt"
LNA = "countries/Lenia.txt"
GRA = "countries/Granda.txt"

VIT = "countries/Ventington.txt"
ATA = "countries/Antlantia.txt"
NTK = "countries/New Tork.txt"

BNA = "countries/Bernia.txt"
HIN = "countries/Hine.txt"
VKA = "countries/Vokenia.txt"

CAJ = "countries/Caji.txt"

MAY = "countries/Mayoji.txt"

IZT = "countries/Izteir.txt"